111111111111111111111111111
10P010000000000010000000101
100C10000000000010000000101
100000000010000010010000101
110111111111111111111100C01
10000000C00000100C000001001
110111111111111111111000001
100000000000001000000001001
110111111111111011111110001
100000CCC00000100C000000011
100000000C00000000C000000E1
10000C101000010011000010101
111111111111111111111111111